# High Overall Stress
Hielo - Zoé
Summer on You - Sam Feldt
Could It Be - CALVIN
Cinematic (feat. Denny White) - Radio Edit - Fedde Le Grand
Round And Round - Ariel Pink
Seventeen - Troye Sivan
In The Morning - Kharfi
Jungle Boyz - Malik Montana
Too Shy - Kajagoogoo
Maria João - Paula Caju
Dreamin' of Love - Stevie B
Chandelier (feat. Lauriana Mae) - B.o.B
The Less I Know The Better - Tame Impala
Undertow - Chroma Key
God's Great Dance Floor - Remix - Reyer
Sirens - Woodlock
These Are The Times (feat. JRM) - Martin Garrix
Shining Star - Earth, Wind & Fire
The Jean Genie - 2013 Remaster - David Bowie
California - Hot Shade
Igual o Peor - Gigolo Y La Exce
What You Did (feat. Ella Mai) - Mahalia
Them Changes - Buddy Miles
Full Moon - Brandy
Lucero - Julia Zenko
Body on My (feat. Brando, Pitbull & Nicky Jam) - Loud Luxury
I Took A Pill In Ibiza - Seeb Remix - Mike Posner
My Number - Foals
Two Tickets to Paradise - Eddie Money
Versace On The Floor (Bruno Mars vs. David Guetta) - Bruno Mars

# High Anxiety
Noche De Sexo - Wisin & Yandel
Quiet Storm - Mobb Deep
Lost In Japan - Shawn Mendes
Moments - Mr. Brackets
Just A Lil Bit - 50 Cent
District - AK Ausserkontrolle
Jerry Sprunger (with T-Pain) - Tory Lanez
Bridging the Gap - Nas
Noche De Sexo - Wisin & Yandel
Bad Vibes - K.Flay
Just A Lil Bit - 50 Cent
Pretty (feat. Jonwayne) - Dabrye
The Code - The Game
Casualties Of A Dice Game - Big L
New Day - South Circle
Blue - Dolo Tonight
Tot - BTNG
With You - Kazura
Unnormal - RAF Camora
U Do It For Me - Algebra Blessett
Rubbin Off The Paint - YBN Nahmir
Marijuano Locos (Stoned Raiders) - Spanish Edit - Cypress Hill
Changes - G-Unit
On and On - Pete Rock & C.L. Smooth
Día y Noche - Liricistas
Becher & Blunt - Haze
Ghettotourist - Sa4
Moments - Mr. Brackets
Resurrection - Common
Diary Of A Madman - Scarface

# High Anxiety-Insomnia
Let It Slide - Freedumb
United - Eclipse
Ping Pong - Armin van Buuren
Metal Health (Bang Your Head) - Quiet Riot
Falling Back - Roosevelt
Sweet Escape - Alesso
Sinner - Drowning Pool
We Remember - Thomas Gold
Runnin (with A$AP Rocky, A$AP Ferg & Nicki Minaj) - Mike WiLL Made-It
Sweet Child O' Mine - Guns N' Roses
Rainbow in the Dark - Dio
Alive And Kicking - Remastered 2002 - Simple Minds
Low - Wage War
Rearview Mirror - Art Of Dying
Highway to Hell - AC/DC
Where I Wanna Be - RMCM
We Own Tonight - Radio Edit - Chris Odd
You're Gonna Go Far, Kid - The Offspring
We Love Like Vampires - Sparks The Rescue
Bumalik Ka Na - Mayonnaise
Cat Scratch Fever - Ted Nugent
Purple Haze - Jimi Hendrix
Sweet Nothing (feat. Florence Welch) - Calvin Harris
Maniac - Conan Gray
Retaliate - VNV Nation
MIROH - Stray Kids
Mr. Brownstone - Guns N' Roses
War of Change - Thousand Foot Krutch
Bang Your Head (Metal Health) - Quiet Riot
Slumber Party - Hellberg